1111111111111111111
1000000001000000001
1011011101011101101
1011011101011101101
1000000000000000001
1011010111110101101
1000010001000100001
1111011101011101111
***1010000000101***
111101011*110101111
****0001***1000****
1111010111110101111
***1010000000101***
1111010111110101111
1000000001000000001
1011011101011101101
1001000000000001001
1101010111110101011
1000010001000100001
1011111101011111101
1000000000000000001
1111111111111111111


*- это пустая клетка
1- это стенка
0- это место где может быть зерно
